1111111111111111111111111
1000000000100000000000001
1000000000100000000000001
1000P00000100000000000001
1000000000100000000000001
1000000000111111000000001
1000000CCC000000000000001
1000000000000000000000001
1000000000000000000000001
1000000000000000EE0000001
1000000000000000000000001
1000000000000000000000001
1111111111111111111111111