1111111111111111111111111
1000000000100000000000001
1000000000100000000000001
1000P00P00100000000C00001
1000000000100000000000001
1000000000111111000000001
100000000000000000E000001
1000000000000000000000001
1000000000000000000000001
1000000C0000000000E000001
1000000000000000000000001
1000000000000000000000001
1111111111111111111111111