1111111111111111111111111
1000000000100000000000001
1000000000100000000000001
1000000000100000000000001
100000P000100000000000001
1000000000111111000000001
1000000000000000000000001
1000000000000000000000001
10000000C0000000000000001
100000000000000EEEE000001
1000000000000000000000001
1000000000000000000000001
1111111111111111111111111