1111111111111111111111111
1000000000100000000000001
1000000000100000000000001
10000000001000000E0000001
1000000000100000000000001
10000P0000111111000000001
1000000000000000000000001
1000000000000000000000001
1000000C00000000000000001
1000000000000000000000001
1000000000000000000E00001
1000000000000000000000001
1111111111111111111111111